		名詞	
さんど	三戸	姓	
けいし	圭史	名	
ひの	日野	姓	
ひでいつ	英逸	名	
さいひんち	最頻値	名詞	
はずれち	外れ値	名詞	
かそく	可測	名詞	
たほう	多峰	名詞	
どうち	同値	名詞	
ちょっこう	直交	名詞	
きょうぎ	狭義	名詞	
こうぎ	広義	名詞	
こうかい	高階	名詞	
ちいき	値域	名詞	
かよう	火曜	名詞	
ぜつえん	絶園	名詞	
とうすうけん	統数研	名詞	
へいいき	閉域	名詞	
せいていち	正定値	名詞	
ふていち	負定値	名詞	
せんざい	潜在	名詞	
こうじげん	高次元	名詞	
せんけいかいき	線形回帰	名詞	
がんけん	頑健	名詞	
ぜんきん	漸近	名詞	
がんけんせい	頑健性	名詞	
ぜんきんてき	漸近的	名詞	
きゅうかい	求解	名詞	
たへんりょう	多変量	名詞	
ぼほなー	ボホナー	名詞	
かそくくうかん	可測空間	名詞	
ひふ	非負	名詞	
たじゅうきょうせんせい	多重共線性	名詞	
ぐうき	偶奇	名詞	
こうかようせい	高可用性	名詞	
きょうぷろ	競プロ	名詞	
るいせきわ	累積和	名詞	
ほうじょ	包除	名詞	
きむ	帰無	名詞	
きむかせつ	帰無仮説	名詞	
こうらく	交絡	名詞	
ちょうきか	超幾何	名詞	
ぼかんすう	母関数	名詞	
きけんきゅうじょ	貴研究所	名詞	
き	貴	名詞	
きんとれ	筋トレ	名詞	
いんがすいろん	因果推論	名詞	
しぶんい	四分位	名詞	
そうけんだい	総研大	名詞	
ぶがいひ	部外秘	名詞	
みつけつごう	密結合	名詞	
そけつごう	疎結合	名詞	
きょういんよう	共引用	名詞	
はんか	汎化	名詞	
はんかせい	汎化性	名詞	
はきょくてん	破局点	名詞	
へいけいしき	閉形式	名詞	
さいゆう	最尤	名詞	
しゅうし	修士	名詞	
まひと	麿人	名詞	
りばたる	リバタル	名詞	
こうじこうぞう	高次構造	名詞	
じすう	次数	名詞	
はくし	博士	名詞	
じんりゅう	人流	名詞	
くうしゅうごう	空集合	名詞	
れいりつ	捩率	名詞	
ちょうてんすう	頂点数	名詞	
してん	始点	名詞	
じょうこん	乗根	名詞	
きょうへんりょう	共変量	名詞	
ぶんるいき	分類器	名詞	
きょうへん	共変	名詞	
はんぺん	反変	名詞	
はんかん	半環	名詞	
くりすとっふぇる	クリストッフェル	名詞	
りっち	リッチ	名詞	
りーまにあん	リーマニアン	名詞	
きか	幾何	名詞	
せつべくとる	接ベクトル	名詞	
こちょう	孤長	名詞	
いんせいしつ	院生室	名詞	
りぷしっつ	リプシッツ	名詞	
しゅきー	主キー	名詞	
きのう	帰納	名詞	
くらすたすう	クラスタ数	名詞	
かくりつでんぱほう	確率伝播法	名詞	
きやく	既約	名詞	
そうきょくちょう	双曲長	名詞	
ゆうこう	有向	名詞	
やとみ	彌冨	名詞	
せいりけん	生理研	名詞	
そかくけん	素核研	名詞	
じゅんせいてき	準静的	名詞	
せいてき	静的	名詞	
きょくちけん	極地研	名詞	
かきかわ	書川	名詞	
		名詞	
		名詞	
